wwwwwwwwwwwwwwwwwwwwwwwww
w p          ww         w
w               w w  w  w
wwww  wwwwwwww         ew 
w                  w    w
wwwwwwwww         ww    w        w
w                 we    w
w    w              w   w 
w w     www    w        w
w        eeeeee     www w
w  w                    w
wwwww  www       ww wwwww            w
w   w                   w
w             wwww      w
w   w   ww              w
w      w wwww           w
w                       w
w   w         www   wwwwww
w                  w  g w 
w               we      w  
wwwwwwwwwwwwwwwwwwwwwwwwww