wwwwwwwwwwwwwwwwwwwwwwwww
w p           ww        w
w               w w  w  w
wwwr  wwwwwwww         ew 
w                  w    w
wwwrrwwwww         ww    w        w
w                 we    w
w    w              w   w 
w w     www    w        w
w        eeeeee     www w
w  w                    w
wwwww  www       ww wwwww            w
w   w                   w
w             wrww      w
w   w   ww              w
w      w rrww           w
w                       w
w   w         wrw   wwrwww
w                  w  g w 
w               we      w  
wwwwwwwwwwwwwwwwwwwwwwwwww