wwwwwwwwwwwwwwwwwwwwwwwwww
w p             w f      w
w               w        w
wf  wr         w         w   
wwrw            w     f  w
w               w        w
w                  wwwww w
w                        w 
w                        w
w f  w                   w 
wwww         www         w
w             f          w
w            www         w
w                        w
w g                 w    w
w                  w   f w
w                   w    w
w       wwrww          f w
w                   w    w
w        f           w   w  
wwwwwwwwwwwwwwwwwwwwwwwwww