wwwwwwwwwwwwwwwwwwwwwwwwww
w p     e        w f     w
w         ee    w        w
wf  wr         w         w   
wwrw            w     f  w
w               w        w
w                  wwwww w
w                        w 
w             eeee       w
w f  w                   w 
wwww         www         w
w             f          w
w            www         w
w    wrwrw               w
w g                 w    w
w     e            w   f w
w             e      w   w
w f      wwrww          fw
w              e     w   w
w   e     f           w  w  
wwwwwwwwwwwwwwwwwwwwwwwwww