wwwwwwwwwwwwwwwwwwwwwwwww
w p                     w
w                       w
w                       w   
w                       w
w                       w
w                       w
w                       w 
w                       w
w                       w
w                       w
w                       w
w                       w
w                       w
w                       w
w                       w
w                       w
w                       w
w                       w
w                     g w  
wwwwwwwwwwwwwwwwwwwwwwwwww