wwwwwwwwwwwwwwwwwwwwwwwww
w p                   b w
w                       w
w                       w   
w             w         w
w                       w
w                       w
w                       w 
w                       w
r                       w
w                       r
w      b                w
w                       w
w                       w
rr                      w
w                       w
w                       w
w                       w
w                    a  w
w  b                     w 
wwwwwwwwwwwwwwwwwwwwwwwwww