wwwwwwwwwwwwwwwwwwwwwwwww
w p                     w
w                       w
w                       w   
w                       w
w                       w
w                       w
w                       w 
w                       w
w                       w
w                       w
w                       w
w                       w
w                       w
w                       w
w                       w
w                       w
w                       w
w                    a  w
w                       w  
wwwwwwwwwwwwwwwwwwwwwwwwww